111111111111111111111111111111111111111111111111111111111111111
111000000000000000000000000000000000000000000000000000000000011
111000000000000000000000000000000000000000000000000000000000011
111000000000000000000000000000000000000000000000000000000000011
111000011111001111110000000100000011111100010000100111111000011
111000010000001000010000000100000010000100011000100100000000011
111000010000001000010000000100000010000100011100100100000000011
111000011111001000010011100100000010000100010110100100011000011
11100000000100100001000P000100000010000100010011100100001000011
111000000001001000010000000100000010000100010001100100001000011
111000011111001111110000000111110011111100010000100111111000011
111000000000000000000000000000000000000000000000000000000000011
111000000000000000000000000000000000000000000000000000000000011
111000000000000000000000000000000000000000000000000000000000011
111000000000000000000000000000000000000000000000000000000000011
111000000000000000000000000000000000000000000000000000000000011
111000000000000000000000000000000000000000000000000000000000011
100000000000000000000000000000000000000000000000000000000001111
100000000000000000011110000000111100000000000000000000000001111
100000000000000000011110000000111100000000000000000000000001111
100000000000000000011110000000111100000000000000000000000001111
10000000000000000001111000E000111100000000000000000000000001111
100000000000000000000000000000000000000000000000000000000001111
100000000000000000000000000000000000000000000000000000000001111
100000000000000000000000000000000000000000000000000000000001111
1000000000000000111CCCCCCCCCCCCCCC11100000000000000000000001111
1000000000000000111CCCCCCCCCCCCCCC11100000000000000000000001111
10000000000000000111CCCCCCCCCCCCC111000000000000000000000001111
100000000000000000111111111111111110000000000000000000000001111
100000000000000000011111111111111100000000000000000000000001111
100000000000000000000000000000000000000000000000000000000001111
100000000000000000000000000000000000000000000000000000000001111
100000000000000000000000000000000000000000000000000000000001111
111111111111111111111111111111111111111111111111111111111111111
111111111111111111111111111111111111111111111111111111111111111
111111111111111111111111111111111111111111111111111111111111111
