11111
00001
11101
11111
00111
